11111111111111111
1PEC00CC00C00C001
111C00CC00C00C001
100C00CC00C00C001
100C00CC00C00C001
100C00CC00C00C001
100C00CC00C00C001
100C00CC00C00C001
11111111111111111