111111111111111
1E0010000000P01
111010111111101
101000101000101
101111101010101
10000000101C101
101111111010101
101000000010001
101011111111111
101010000000001
101010111111101
100010100000001
1011111C1111101
10000CC01000001
111111111111111