11111111111111111111
1E0000000000100CCC11
1111111111101C111011
100000101000101CPC11
1011101C1C1111101C11
10C01000100000101011
101C111111111C101011
1C1C00000CC000001011
11111111111111111111
11111111111111111111