111111111111111111111
1E1C00000C1000100C001
101111101011101C10111
10C000101000101010C01
111110101110101011101
100000101C00100000101
101111101C111111111C1
10CC00101000100CC0001
11111C1P1110101111101
100000001000001000C01
111111111111111111111